4 4
0 0 0 0 0 0
1 0 1 0 0 0
2 0 0 1 1 0
3 0 1 1 0 1
0 1 0 0 0 0
1 1 1 0 0 1
2 1 0 0 1 0
3 1 1 1 0 0
0 2 1 0 0 1
1 2 0 1 1 1
2 2 1 0 0 1
3 2 1 0 1 0
0 3 0 1 1 1
1 3 0 1 0 1
2 3 0 1 0 1
3 3 1 0 0 1
START
1
3 0 u
GOAL
4
0 3 u
0 3 l
0 3 d
0 3 r
40
