6 5
0 0 0 1 1 0
1 0 0 1 0 0
2 0 0 1 0 0
3 0 0 1 0 0
4 0 0 1 0 0
5 0 1 1 0 0
0 1 0 0 1 0
1 1 0 0 0 0
2 1 0 0 0 0
3 1 0 0 0 0
4 1 0 0 0 0
5 1 1 0 0 0
0 2 0 0 1 1
1 2 0 0 0 1
2 2 0 0 0 0
3 2 0 0 0 0
4 2 0 0 0 0
5 2 1 0 0 0
0 3 0 1 1 0
1 3 1 1 0 1
2 3 0 0 1 0
3 3 0 0 0 0
4 3 0 0 0 0
5 3 1 0 0 0
0 4 0 0 1 1
1 4 1 1 0 1
2 4 0 0 1 1
3 4 0 0 0 1
4 4 0 0 0 1
5 4 1 0 0 1
START
1
0 0 u
GOAL
4
5 0 u
5 0 l
5 0 d
5 0 r
10
